#########################################
####    #       #       ##      #     ###
# ....  # ..... #  ...  #  ....## ..... #
# .  #. # . #   # . # . # .     # . #   #
# .   . # .     # .   . # . ##### .   # #
# ....  ##....#   .....   .$      ....$ #
# .     # .     # .   . # . ##### .   # #
# . ##### . # $ # . # . # .     # . #   #
# .$#     ..... # .$# . #  .... # .....##
#     @ #   #   #   #   ##     ##      ##
#########################################